7th ICITCS 	Seoul, South Korea,,
AAAI 	New Orleans, Louisiana,,
AAIA 	Prague, Czech Republic,,
AAMAS 	Stockholm,,
ACIIDS 	Kaohsiung, Taiwan,Dong Hoi City, Vietnam,,
ACIS 	Krabi, Thailand,,
ACL 	Melbourne, Australia,,
ACLing 	Dubai, UAE,,
ACM - DTTA Track 	Coimbra, Portugal,,
ACM - ICBDM 	Macau, China,,
ACM - ICBDR 	Osaka, Japan,,
ACM - ICIAI 	Shanghai, China,,
ACM - ICMLC 	Macau, China,,
ACM - ICMLSC 	Phuoc Island, Vietnam,,
ACM SAC-COCO 	Pau, France,,
ACM SAC-RS 	Marrakech, Morocco,Pau, France,,
ACM--ICCDA, and ISI 	DeKalb,IL,USA,,
ACM--ICCIP 	Tokyo, Japan,,
ACM--ICDEL 	Beijing, China,,
ACM--ICDPA 	Guangzhou, China,,
ACM--ICMCE 	St. Petersburg, Russia,,
ACM--ICMSR and ISI 	Singapore,,
ACM--ICRIS 	Amsterdam, Netherland,,
ACM--ICSSE 	Prague, Czech Republic,,
ACM-BCB 	Boston, MA,,
ACML 	Hamilton, New Zealand,Seoul, South Korea,,
ACMLC 	Singapore,,
ACUMEN 	ICDM17, New Orleans, USA,,
ADBIS 	Vienna, Austria,Nicosia, Cyprus,,
ADC 	Melbourne,Brisbane, Australia,,
ADCOM 	Dubai, UAE,,
ADMA 	Singapore,Gold Coast,,
ADMI 	Sao Paulo, Brazil,,
AECIA 	Marrakech, Morocco,,
AFRICOMM 	Ouagadougou, Burkina Faso (West Africa),,
AGI 	Melbourne, Australia,,
AHS 	Caltech, Pasadena, CA, USA,,
AI 	Chennai, India,Hobart, Australia,Melbourne, Australia,,
AI*IA 	Bari,,
AIAAT 	Hawaii, USA,Hawaii, USA,,
AIAI 	Rhodes island Greece,,
AIAP 	Vienna, Austria,Zurich, Switzerland,,
AIAPP 	Geneva, Switzerland,,
AICPDES 	Porto, Portugal,,
AICS 	Dublin, Ireland,,
AIED DC 	Wuhan, China,,
AIFU 	Dubai, UAE,,
AIFZ 	Dubai, UAE,,
AIKED 	Cambridge, UK,,
AIM@EPIA 	Porto, Portugal,,
AIMS 	Honolulu, Hawaii, USA,Seattle, USA,,
AIMSA  	Bangalore India,,
AIPR 	Washington DC,,
AISB 	Bath, Uk,,
AISI 	Cairo, Egypt,,
AISP-	Shiraz,,
AIST 	Moscow, Russia,,
AISTATS 	Fort Lauderdale, Florida, USA,Playa Blanca, Lanzarote,,
AITS@EPIA 	Porto,,
AKG 	Tokyo,,
ALT 	Lanzarote, Spain,,
ALatIKNOW 	Graz, Austria,,
AMBN 	Kyoto,,
AMLTA 	Cairo, Egypt,,
APCCM 	Adelaide, South Australia, Australia,Auckland,,
APWeb 	Suzhou,Guangzhou, China,,
ARIA 	Dubai, UAE,,
ARIN 	Dubai, UAE,,
ASIIS (ACM SAC) 	Coimbra, Portugal,,
Algorithmic news 	Munich, Germany,,
Archiving 	Riga, Latvia,,
AusDM 	Melbourne, Australia,,
BAFI 	Santiago, Chile,,
BCI 	Skopje,,
BDA 	Hyderabad, India,,
BDAS 	Poznan, Poland,Ustron, Poland,Ustron, Poland,Ustron near Krakow (Cracow), Poland,Ustron near Krakow (Cracow), Poland,Ustron, Poland,Ustron near Krakow (Cracow), Poland,,
BDCAT 	Austin, Texas, USA,,
BDI 	Kuala Lumpur, Malaysia,,
BDIOT - ACM 	London, UK,,
BDTA 	Seoul, South Korea,,
BDVA 	Adelaide, Australia,,
BFAL 	Patras,,
BI 	Beijing, China,,
BRACIS 	Uberlandia, MG - Brazil,,
BRAIN 	Bacau,,
BTW 	Stuttgart, Germany,,
Balisage 	Montreal, Canada,,
Big Data 	Alicante, Spain,,
BigData Congress 	Seattle, USA,,
BioASQ 	Part of BioNLP 2017 (Vancouver, Canada),,
BioS 	Chennai, India,,
CAIA 	Berlin, Germany,,
CAIIT 	Hong Kong,,
CAnimAI 	Arras, France,,
CBR@FLAIRS 	Marco Island,,
CCIA 	Universitat Pompeu Fabra, Barcelona,,
CCIS 	Hangzhou, China,,
CCKS 	Chengdu, China,,
CCML 	Shenzhen, China,,
CCSEA 	Melbourne, Australia,,
CCSEIT 	Vienna, Austria,Zurich, Switzerland,,
CD-MAKE 	Reggio di Calabria,,
CECIIS 	Varazdin, Croatia,,
CEEC 	Colchester, UK,,
CIARP 	Valparaiso, Chile,,
CIBB 	Stirling, Scotland, Great Britain,,
CICCI 	La Habana, Cuba,,
CICLOPS 	Melbourne, Australia,,
CIDR 	Asilomar, California,,
CIESC 	Naiguat�, VENEZUELA,,
CIG 	Maastricht, the Netherlands,,
CIIS 	Brunei,,
CIKM 	Glasgow, Scotland, UK,Singapore,Maui, USA,,
CIKM Posters 	Maui, USA,,
CILC 	Naples,,
CIPI 	Cuba,,
CISIM 	Venice, Italy,,
CITI 	Guayaquil, Ecuador,,
CLEI 	Naiguat�, VENEZUELA,,
CLOSER 	Funchal, Madeira, Portugal,,
CLTM 	Naiguat�, VENEZUELA,,
CMC 	Sydney, Australia,,
CML 	Barcelona, Spain,,
CN4IoT 	Brindisi,,
CNSA 	Zurich, Switzerland,,
COLT 	Stockholm, Sweden,,
COMAD 	Hyderabad, India,Pune, India,Bangalore, Karnataka, India,Pune, India,Ahmedabad, India,,
COMLACO 	Melbourne,,
COMPRAIL 	Madrid, Spain,,
CORE 	Mexico City,,
CORES 	Polanica Zdroj, Poland,,
COSIT 	Santa Fe, New Mexico, USA.,,
CPAIOR 	Delft, The Netherlands,,
CPSCom 	Chengdu, Sichuan, China,,
CRC 	Chengdu, China,,
CRoNe 	Valparaiso, Chile,,
CSAI 	Kalbis Institute, Jakarta, Indonesia,,
CSBio 	NhaTrang, Vietnam,,
CSE 	Paphos, Cyprus,,
CSEN 	Vienna, Austria,,
CSI 	Shiraz,,
CSITEC 	Dubai, UAE,,
CSITY 	Dubai, UAE,,
CSPA 	MALAYSIA,,
CSPRED 	Raleigh, U.S.,,
CST 	Dubai, UAE,Sydney, Australia,,
CSTY 	Chennai, India,,
CVPR 	SALT LAKE CITY, UTAH,,
CYBI 	Geneva, Switzerland,,
CoSIT 	Geneva, Switzerland,,
CyberC 	Chengdu, China,Nanjing,,
DALI 	Toulouse, France,,
DAPS 	Barcelona, Spain,,
DASFAA 	Suzhou,Wuhan, China,,
DASFAA (Demo Track) 	Hanoi, Vietnam,,
DATA 	Vienna, Austria,Rome, Italy,Madrid, Spain,,
DATA STREAMS TRACK 	Marrakech, Morocco,,
DB&IS 	Vilnius, Lithuania,Riga, Latvia,Tallinn, ESTONIA,Tallinn, ESTONIA,,
DBDBD 	Antwerp, Belgium,Brussels, Belgium,Rotterdam, Netherlands,,
DBKDA 	Reunion Island,,
DBPL 	Trento, Italy,Seattle, USA,,
DCAI 	Toledo (Spain),Porto, Portugal,,
DCNET 	Rome, Italy,,
DEAs 	Universiti Teknologi Brunei,,
DEBS 	Barcelona, Spain,,
DEW 	Poznan, Poland,,
DEXA 	Prague, Czech Republic,Toulouse, France,,
DILS 	Montreal, Quebec,Luxembourg,Lisbon, Portugal,,
DIPDMWC 	Universitas Mercu Buana - Meruya Campus,Moscow, Russia,,
DKMP 	Dubai, UAE,,
DLRS 	Boston, USA,,
DMA 	Geneva, Switzerland,,
DMAP 	Dubai, UAE,,
DMBD 	Fukuoka, Japan,,
DMCIT 	Shanghai, China,,
DMCS 	New Orleans,,
DMDB 	Vienna, Austria,,
DMS 	Zurich, Switzerland,Sydney, Australia,Dubai, UAE,,
DM_FLAIRS 	Melbourne, FL, USA,,
DRCN 	Orange Gardens, Paris area, France,,
DS 	Kyoto, Japan,Bari, Italy,,
DSA 	New York,,
DSAA 	Paris, France,Tokyo, Japan,Montreal, Canada,,
DSCI 	San Francisco,,
DSSD 	Tokyo, Japan,,
DT 	TU Dortmund, Germany,,
DTMN 	Dubai, UAE,,
DaEng 	Kuala Lumpur, Malaysia,,
DaWaK 	Lyon, France,Toulouse, France,Vienna, Austria,Prague, Czech Republic,Munich, Germany,Valencia, Spain,,
DiPP 	Veliko Tarnovo, Bulgaria,,
DocEng 	Mountain View, CA, USA,,
EAIS 	island of Rhodes GREECE,,
EANN 	Athens, Greece,Aberdeen, Scotland,,
EAST - FLAIRS 	Marco Island, Florida,,
ECCV 	Munich, Germany,,
ECDMO 	Krakow, Poland,,
ECML-PKDD 	Skopje, Macedonia,,
ECSA 	Online,,
EDB 	Seoul, South Korea,Incheon, Korea,,
EDBT 	Athens, Greece,Vienna, Austria,,
EDBT/ICDT 	Athens, Greece,,
EDC 	Bangkok, Thailand,,
EI--AIACT 	Wuhan, China,,
EI--CMVIT 	Hong Kong,,
EI-CCEAI 	Boracay, Philipines,,
EI-ICDES 	Kortrijk, Belgium,,
EMNLP 	Copenhagen, Denmark,,
EMSA 	Melbourne, Australia,,
ER 	Gifu (Japan),,
ESANN 	Bruges, Belgium,,
ESWC 	Portoroz, Slovenia,,
Ei - ICBCT 	Hanoi, Vietnam,,
Ei - ICCAE 	Brisbane, Australia,,
Ei - ICVARS 	Brisbane, Australia,,
EiDMKD 	Beijing, China,,
Electronic Imaging 	Burlingame, CA,,
EnviroInfo 	Oldenburg, Lower Saxony, Germany,,
EuroGP 	Amsterdam,,
EvoMUSART 	Amsterdam,,
FADS 	China,,
FAT* 	New York City, USA,,
FDM 	Chemnitz,,
FDML 	Kaohsiung, Taiwan,,
FDSE 	Ho Chi Minh City, Vietnam,,
FICC 	Singapore,,
FLAIRS 	Melbourne, FL, USA,Marco Island, Florida,,
FTC 	Vancouver, Canada,,
Fashion-ML-KDD 	Halifax, Nova Scotia - Canada,,
FedCSIS 	Prague, Czech Republic,,
FoIKS 	Budapest, Hungary,Bordeaux, France,,
GCAI 	Miami, USA,Berlin, Germany,,
GECCO 	Kyoto, Japan,,
GISCUP 	Los Angeles, CA,,
GOODTECHS 	Venice,,
GRADES 	Snowbird (Utah), USA,New York, USA,,
GTM 	Atlanta, GA,,
GlobalSIP 	Montreal, Canada,,
Globe 	Toulouse, France,,
GreenCom 	Chengdu, Sichuan, China,,
HAIS 	Logro�o (La Rioja) Spain,,
HDMS 	Chania, Crete, Greece,Athens, Greece,,
HIS 	Beijing, China,,
HPCAC 	Leon Spain,,
HSI 	Ulsan, Korea,,
HealTech 	Nice, France,,
IALP 	Singapore,,
IC-ININFO 	Athens, Greece,,
ICAART 	Funchal, Madeira, Portugal,,
ICACCP 	Gangtok, Sikkim, India,,
ICACNI 	Goa, India,,
ICACR 	Wuhan, China,,
ICACS - EI 	Jeju Island, South Korea,,
ICACSIS 	Malang, Indonesia,Bali,,
ICAIL 	London,,
ICAIR 	Prague,,
ICAISC 	Zakopane, Poland,,
ICAISE 	Chengdu, China,,
ICAITA 	Sydney, Australia,,
ICAMS 	Torino, Italy,,
ICANN 	Alghero, Sardinia, Italy,,
ICAPM , EI 	Phuket, Thailand,,
ICBBB - Ei 	Tokyo, Japan,,
ICBBE - Ei 	Seoul, South Korea,,
ICBBT- Ei 	Lisbon, Portugal,,
ICBCB 2018 	Chengdu, China,,
ICBDC 	Shenzhen, China,,
ICBDE 	Honolulu, Hawaii, USA,,
ICBDSC 	Casablanca, Morocco,,
ICBDT 	Hangzhou, China,,
ICBEA--Ei 	Hong Kong,,
ICBEB 	Bangkok, Thailand,,
ICBEF 	Seoul, South Korea,,
ICBNA 	Tunisia,,
ICBRA - Ei 	Barcelona, Spain,,
ICCAC DS 	Tucson, AZ,,
ICCAI 	Chengdu, China,,
ICCAIRO 	Prague, Czech Republic,,
ICCASA 	Dong Hoi City, Vietnam,,
ICCBB - Ei 	New Jersey, USA,,
ICCBDC 	London, UK,,
ICCBDC - ACM 	London, UK,,
ICCBR 	Stockholm, Sweden,,
ICCCB - Ei 	Barcelona, Spain,,
ICCCBDA 	Chengdu, China,,
ICCCS 	Nagoya, Japan,,
ICCDE 	Shanghai, China,,
ICCIA 	Beijing, China,,
ICCIDE 	Vijayawada, India,,
ICCIDM 	Odisha, India,,
ICCIDS 	Chennai,,
ICCMIT 	Poland,,
ICCMS  	Sydney, Australia,,
ICCRE 	Nagoya, Japan,,
ICCRI 	Kuala Lumpur, Malaysia,,
ICCSP  	Guiyang, China,,
ICCST 	Madrid,,
ICCTD	Istanbul, Turkey,,
ICCTIM 	Metropolitan College, Greece,,
ICCTS - Ei 	Singapore,,
ICDE 	San Diego,Helsinki, Finland,Brisbane, Australia,Chicago, USA,,
ICDIM 	Islamabad,Porto, Portugal,Fukuoka, Japan,,
ICDIP-SPIE 	Shanghai, China,,
ICDIS 	South Padre Island, Texas, USA,,
ICDM 	Atlantic City, NJ, USA,NEW ORLEANS, USA,Barcelona, Spain,New York,,
ICDME - IOP 	Guangzhou, China,,
ICDPR 	Boracay, Philipines,,
ICDSE 	Kochi,,
ICDT 	Berlin, Germany,Genoa, Italy,,
ICE-B 	Rome, Italy,,
ICECIT 	Tumkur,,
ICFCC 	Singapore,,
ICFCC - Ei 	Nagoya, Japan,,
ICFIP 	Barcelona, Spain,,
ICGDA 	Prague, Czech Republic,,
ICIA 	Lodz, Poland,,
ICIAS 	Singapore,,
ICIBB - Ei 	Bangkok, Thailand,,
ICICA 	Sydney, Australia,,
ICICC  	Manila, Philippines,,
ICICS 	Amman, Jordan,,
ICICT 	India,,
ICIGP 	Hong Kong,,
ICIIC 	Singapore,,
ICIII 	Krakow, Poland,,
ICIIP 	London, UK,Guilin,,
ICIIT 	Hanoi, Vietnam,,
ICIKM 	Bali, Indonesia,,
ICINCO 	Madrid, Spain,,
ICINT  	Osaka, Japan,,
ICIS 	Shanghai, China,,
ICIS- 	Kochi, Kerala,,
ICISDM 	Florida, USA,,
ICISIP 	Hawaii, USA,Matsue, Japan,,
ICISS 	Jeju Island, South Korea,,
ICIST 	Dubai, UAE,,
ICITDA 	Yogyakarta, Indonesia,,
ICITE 	Singapore,,
ICKD 	Penang, Malaysia,,
ICKEA 	Moscow, Russia,,
ICKSE 	Istanbul, Turkey,,
ICLR 	Vancouver, Canada,Palais des Congr�s Neptune, Toulon, France,,
ICMAI 	Chengdu, China,,
ICMAM - Ei 	Phuket, Thailand,,
ICMCR  	Ho Chi Minh, Vietnam,,
ICMCT 	Singapore,,
ICME 	San Diego, California, USA,,
ICMEAE 	Nagoya, Japan,,
ICMERR 	Paris, France,,
ICML 	Sydney, Australia,,
ICMLA 	Los Angeles, California, USA,CANCUN, MEXICO,,
ICMLT 	Jinan, China,,
ICMM 	Phuket, Thailand,,
ICMME - Ei 	Kuala Lumpur, Malaysia,,
ICMMM - EI 	Atlanta, USA,,
ICMR 	Bucharest, Romania,,
ICMRA 	Hefei, China,,
ICMRE 	Valenciennes, France,,
ICMSC - Ei 	Moscow, Russia,,
ICMSCE 	Amsterdam, Netherland,,
ICMV 	Vienna, Austria,,
ICMVA 	Singapore,,
ICOAI 	Florence, Italy,,
ICOAR  	Maldives,,
ICOAS - EI 	Phnom Penh, Cambodia,,
ICOCB - EI 	Yogyakarta, Indonesia,,
ICONIP 	Guangzhou, China,,
ICPET 	Deir El-Balah, Palestine,,
ICPR 	Beijing, China,,
ICPRAI 	Montreal, Quebec,,
ICPRAM 	Funchal, Madeira, Portugal,Porto, Portugal,,
ICRACA 	Pune, India,,
ICRAE 	Shanghai, China,,
ICRAE - IEEE 	Shanghai, China,,
ICRAI 	Shanghai, China,,
ICRCA - Ei 	Kitakyushu, Japan,,
ICRIC 	Nagoya, Japan,,
ICRMV - Ei 	Kitakyushu, Japan,,
ICROM-Ei 	Hong Kong,,
ICSC 	Laguna Hills, CA,,
ICSCA - ACM 	Kuantan, Malaysia,,
ICSCE 	Jaipur, India,,
ICSN 	Kuala Lumpur, Malaysia,,
ICSR 	Tsukuba, Japan,,
ICSRT--ACM, 	Chengdu, China,,
ICSS 	Sydney, Australia,,
ICT &amp; KE 	Bangkok, Thailand,,
ICTCC 	Dong Hoi City, Vietnam,,
ICTTE 	Hong Kong,,
ICUASA 	Shanghai,,
ICVIP - Ei 	Singapore,,
ICVR-Ei 	Hong Kong,,
ICWS 	Santa Clara, CA, USA,,
IDA 	Stockholm,London, UK,,
IDAM 	Kaohsiung, Taiwan,,
IDAP 	Malatya, Turkey,,
IDEAL 	Guilin, China,Hangzhou, China,,
IDEAS 	Lisbon,Barcelona,Prague,Bristol,Lisbon,,
IE 	Seoul, South Korea,,
IEA/AIE NAAD 	Arras, France,,
IECON 	Beijing, China,,
IEEE 	Wuhan, China,,
IEEE - ICBDA 	Shanghai, China,,
IEEE - ICKEA 	London, United Kingdom,,
IEEE Big Data 	Boston, MA, USA,,
IEEE BigDataService 	Bamberg, Germany,,
IEEE Bigcomp 	Shanghai, China,,
IEEE CISDA 	Honolulu, Hawaii, USA,,
IEEE DSAA&apos;	Montreal, Canada,,
IEEE FRUCT 	Petrozavodsk, Russia,Helsinki, Finland,,
IEEE HPSC 	Shenzhen, China,,
IEEE ISI 	Beijing, China,,
IEEE ITNEC 	Chengdu, China,,
IEEE ITOEC 	Chongqing,,
IEEE SSCI 	Honolulu, Hawaii, USA,,
IEEE icSoftComp 	Changa, Anand, India,,
IEEE--ICAVE 	Singapore,,
IEEE--ICICT 	DeKalb,IL,USA,,
IEEE--ICSGSC 	Singapore,,
IEEE--ISCBI 	Dubai, UAE,,
IEEE-ICCAR 	Nagoya, Japan,Auckland, New Zealand,,
IEEE-ICMSC 	St. Petersburg, Russia,,
IEEE-SITIS2017: MIRA 	Jaipur, India,,
IEMIS 	Kolkata,,
IES 	Hanoi, Vietnam,,
IFAC World Congress SIMCA 	Toulouse, France,,
IIP 	Melbourne,,
IJCAI 	Stockholm, Sweden,Melbourne, Australia,,
IJCNN 	Anchorage, Alaska, USA,,
IJCRS 	Olsztyn, Poland,,
ILP 	France,,
IML 	Liverpool, United Kingdom,,
IMMM 	Venice, Italy,,
INCISCOS 	Quito - Ecuador,Quito - Ecuador,,
INISTA 	Thessaloniki, Greece,,
INIT/AERFAISummerSchoolML 	Spain,,
INNS-BDDL 	Bali, Indonesia,,
INTECH 	Rabat,,
IPMU 	Cadiz (Spain),,
IPTA 	Montreal, Canada,,
IREHI 	Lome/Togo,,
IROS 	Vancouver, Canada,,
IRRATIONAL 	Barcelona,,
IS 	Ulyanovsk, Russia,,
ISAIR 	Kitakyushu, Japan,,
ISASE-MAICS 	Spokane, WA, USA,,
ISCBI 	Olten, Switzerland,,
ISCI 	Penang, Malaysia,,
ISCIA 	Melaka, Malaysia,,
ISCMI 	Dubai, UAE,,
ISCMI - IEEE 	Republic of Mauritius,,
ISCSAI 	Shenzhen,,
ISDM 	Nice, France,,
ISDSA 	Milan, Italy,,
ISICS 	Merida, Mexico,,
ISIS 	Daegu, South Korea,,
ISMIS 	Warsaw, Poland,,
ISMIS 2017 DM Competition 	Online,,
ISMSI 	Phuket, Thailand,,
ISMW FRUCT 	St. Petersburg, Russia,,
ISNN 	Minsk, Belarus,,
ISS for IISA Conference 	Cyprus,,
ISWC 	Vienna, Austria,,
ISWC poster&amp;demo 	Vienna,,
ISWC-InUse 	Sydney, Australia,,
ITBAM 	Porto,,
ITCCMA 	Dubai, UAE,,
ITCS 	Dubai, UAE,,
ITCSE 	Zurich, Switzerland,,
ITMLS 	Barcelona, Spain,,
ITNG 	Las Vegas,,
ITPF 	Mashhad,Iran,,
ITS 	Montreal, Canada,,
IUI 	Limassol, Cyprus,,
IUPT 	London, UK,Hasselt, Belgium,,
Infitt-TIC 	Toronto,,
JSE 	Dubai, UAE,,
K-CAP 	Austin, Texas, USA,,
KACSTIT 	Riyadh, Saudi Arabia,,
KALSIMIS 	Funchal, Madeira,,
KAM 	Lodz, Poland,,
KEOD 	Paris, France,,
KES-IDT 	Gifu (Japan),,
KES-IDT / IABIRP 	Vilamoura, Algarve, Portugal,,
KI 	TU Dortmund, Germany,,
KRR@SAC 	Pau, France,,
L@S 	Massachusetts Institute of Technology, C,,
LABELS 	Quebec, Canada,,
LDK 	Galway/Ireland,,
LKE 	Puebla, Mexico,,
LOPAL 	Rabat, Morocco,,
LPAR 	Maun, Botswana,,
MACE - Ei 	Manila, Philippines,,
MAICS 	Fort Wayne, IN,,
MALHE 	Reggio di Calabria,,
MASTA@EPIA 	Porto,,
MCSD 	Poznan, Poland,,
MDM 	Bangalore India,Brisbane, Australia,,
MECH 	Vienna, Austria,,
MECN 	Dubai, UAE,,
MEDI 	Amantea, Calabria, Italy,Poitiers, Futuroscope, France,,
MEDS 	Chennai, India,,
MENDEL SCC 	Brno, Czech Republic,,
MESS 	Taormina-Sicily, Italy,,
MIG 	Barcelona, Spain,,
MIKE 	IDRBT, Hyderabad, India,,
MLDM 	New York,New York, USA,,
MLSA 	Riva del Garda,,
MMM 	Bangkok, Thailand,,
MOCO 	London UK,,
MOD 	Volterra (Pisa) Tuscany,,
MVIP 	Isfahan, Iran,,
MaLTeSQuE 	Klagenfurt,,
MedPRAI 	Rabat, Morocco,,
MindCare 	Barcelona, Spain,,
NAACL HLT 	New Orleans, Louisiana,,
NATP 	Dubai, UAE,,
NEDB 	Cambridge, MA, USA,,
NIMD 	Rome, Italy,,
NIPS 	Long Beach, CA, USA,,
NIPS ML4HC 	Barcelona, Spain,,
NIPS-CAI 	Long Beach, California,,
NLP 	Dubai, UAE,,
NLPCC 	Dalian, China,,
NTMS 	Dubai, UAE,,
NWCOM 	Dubai, UAE,,
NeTCoM 	Dubai, UAE,,
NetCrime 	Indianapolis, Indiana, USA,,
NetSys PhD Forum 	Stuttgart, Germany,,
NextComp 	Mauritius,,
ODBASE 	Graz, Austria,Amantea, Italy,,
Oriental COCOSDA 	Macau, China,,
PACLING 	Yangon, Myanmar,,
PACMA 	Trieste, Italy,,
PAD 	Springer,,
PAIS&apos;	Khenchela, Algeria,,
PAKDD 	Jeju Island, Korea,Melbourne, Australia,,
PAML 	Reggio di Calabria,,
PAPIs 	Boston,,
PBDA 	Warsaw, Poland,,
PICICT 	Gaza ( Palestine ),,
PLP 	Orl�ans - France,,
PODS 	Scottsdale, Arizona, USA,New York, USA,Snowbird (Utah), USA,,
PQ 	Rio de Janeiro, Brazil,,
PReMI 	Kolkata, India,,
QUALICO 	Wroclaw, Poland,,
RA 	Cambridge, Massachusetts, USA,,
RAAI 	Bucharest,,
RDA 	Osaka, Japan,,
RO-MAN 	Nanjing and Tai&#8217;an, China,,
RSmeetDBs 	Toulouse,,
RTIS 	Beijing, China,,
Randomized ML @ ESANN 	Bruges, Belgium,,
RecSys@FLAIRS 	Marco Island,,
RiTA 	KAIST, Daejeon, KOREA,,
Robot 	Seville,,
RuleML+RR 	London,,
S3P 	Capri (Italy),,
SAI 	Sydney, Australia,,
SAT 	Melbourne, Australia,,
SBBD 	Uberlandia, MG - Brazil,Curitiba, Brazil,Sao Paulo, Brazil,,
SBD 	Raleigh, U.S.,,
SBDS 	Caen, France,,
SCDS 	Kuala Lumpur,Yogyakarta, Indonesia,,
SCIA 	Troms�, Norway,,
SDAAM 	Washington DC,,
SDM 	San Diego, USA,Austin, Texas, USA,,
SDS 	Bern, Switzerland,,
SEBD 	Sorrento Coast, Italy,Venice, Italy,Maratea, Italy,Roccella Jonica (RC) - ITALY,,
SIGI 	Chennai, India,,
SIGMOD 	Melbourne, Australia,New York,Scottsdale, Arizona, USA,Raleigh,San Francisco,,
SIGSPATIAL 	Los Angeles, CA,,
SIMBig 	Cuzco,,
SIN 	Aksaray, Turkey,,
SIPRO 	Dubai, UAE,,
SISAP 	Glasgow, UK,Tokyo, Japan,Toronto, Canada,,
SISAP  	Los Cabos, Mexico,,
SLIE 	Melbourne, Florida,,
SLIOIA/ASAI 	C�rdoba, Argentina,,
SMART 	Timisoara, Romania,,
SMMA 	Exeter, England,,
SNMAM 	Cusco, Peru,,
SOTM-EU 	Vienna, Austria,,
SPECOM 	Leipzig, Germany,,
SSCI 	Athens, Greece,,
SSDBM 	Chania, Crete, Greece,,
SSTD 	Munich, Germany,Seoul, South Korea,,
ST-Analytics 	Trieste, Italy,,
SUM 	Dayton, Ohio,Quebec, Canada,Marburg, Germany,,
SYNASC 	Timisoara,,
SYRCoDIS 	Kazan, Russia,Veliky Novgorod, Russia,Moscow, Russia,,
Sideways 	Madeira,,
Smart X 	Guangzhou,,
Smart-CT 	M�laga,,
SmartData 	Chengdu, Sichuan, China,,
SoCC 	Santa Clara, California, USA,San Jose, CA,,
SoDAC 	Bangkok, Thailand,,
SoICT 	NhaTrang, Vietnam,,
SwissText 	Winterthur - Switzerland,,
TAAI 	Taipei, Taiwan,,
TFML 	Krakow, Poland,,
TIME 	Copenhagen, Denmark,Mons, Belgium,,
TPCTC 	Seattle, WA,,
TRAP 	Rome,,
TSD 	Prague,,
UAI 	Sydney, Australia,,
VAAM 	CANCUN, MEXICO,,
VDA 	Burlingame, CA,,
VISAPP 	Funchal, Madeira, Portugal,,
VLDB 	New Delhi,Istanbul, Turkey,Hangzhou, China,Lago Di Garda, Trento, Italy,Kohala Coast, Hawaii, USA,,
VS3 	Prague,,
WI 	Leipzig, Germany,,
WISE 	Moscow, Russia,Paphos, Cyprus,,
WISTIPS 	Druskininkai, Lithuania,,
WSDM 	Cambridge, UK,,
WSDM Cup 	Cambridge,,
We RISE 	Atlanta, GA, US,,
Workshop on Massive Dataflow Analysis 	Hammamet, Tunisia,,
XLDB 	Menlo Park, CA,,
iCICS 	Irbid, Jordan,Irbid, Jordan,,
iDSC 	Salzburg, Austria,,
iSAI-NLP 	Hua-Hin, Prachuapkirikan,Thailand,,
iThings 	Chengdu, Sichuan, China,,
miproBIS 	Opatija, Croatia,,
